///////////////
/      @      /
/             /
/         $   /
/   $         /
/             /
/////// ///////
/  !       $  /
/             /
/             /
/       %     /
/             /
/             /
///////#///////