/////////////
/     @     /
/ $       $ /
/           /
/           /
////// //////
/ M       $ /
/           /
/           /
/           /
/           /
//////#//////