///////////////
/      @      /
/             /
/         $   /
/   $         /
/             /
/////// ///////
/  M       $  /
/             /
/             /
/       %     /
/             /
/             /
///////#///////